BBBBBBBBBBBBBBBBBBBBBBBBBBBBBB
B                            B
B                            B
B                            B
B        111111111111        B
B2222222222222222222222222222B
B    11111111111111111111    B
B        222222222222        B
B1111111111111111111111111111B
B                            B
B                            B
B                            B
B                            B
B                            B
B                            B
B                            B
B                            B
B                            B
B                            B
B                            B