BBBBBBBBBBBBBBBBBBBBBBBBBBBBBBBBBBBBB
B                                   B
B                                   B
B   55555555555555555555555555555   B
B   51     1     131     1     15   B
B   5 1   1 1   1 3 1   1 1   1 5   B
B   5  1 1   1 1  3  1 1   1 1  5   B
B   5   1     1   3   1     1   5   B
B   55555555555555555555555555555   B
B                                   B
B11111111111111111111111111111111111B
B                                   B
B                                   B
B                                   B
B                                   B
B                                   B
B                                   B
B                                   B
B                                   B
B                                   B
B                                   B
B                                   B
B                                   B