BBBBBBBBBBBBBBBBBBBBBBBBBBBB
B                          B
B                          B
B   111111        111111   B
B                          B
B                          B
B  1111111111111111111111  B
B      11111111111111      B
B  111111111111111111111   B
B      11111111111111      B
B                          B
B                          B
B    2222         2222     B
B                          B
B                          B
B                          B
B                          B
B                          B
B                          B
B                          B
B                          B