BBBBBBBBBBBBBBBBBBBBBBBBBBBBBB
B                            B
B                            B
B                            B
B  111111111111111111111111  B
B1111111111111111111111111111B
B                            B
B                            B
B                            B
B                            B
B                            B
B                            B
B                            B
B                            B
B                            B